R  1000 800  

NO    textures/brick1.xpm
SO   textures/brick2.xpm 
WE  textures/brick3.xpm  
EA textures/brick5.xpm

C 100,200,255 
F 128,128,128

        1111111111111111111111111
        1000000000110000000000001
        1011000001110000000000001
        1001000000000000000N00001
111111111011000001110000000000001
100000000011000001110111111111111
11010111111111011111111111111
11100111111111011000000000001
11000000110101011000000000001
100000000000000000000000000011111
10000000000000001000000000001
11000001110101011100000000001
11110111 1110101 101111010001
11111111 1111111 111111111111
