R  600 400

NO    textures/brick1.xpm

SO   textures/brick10.xpm
WE  textures/brick3.xpm  
EA textures/brick4.xpm

C    0,200,255 

F 254,128,128

111111111111111111111111
100000000000000000000001
100000000000000000000001
100000000000000000000001
100000111110000101010001
100000100010000000000001
100000100010000100010001
100000100010000000000001
1000001101100001010100011
1000000000000000000000001
1000000000000000000000011
10000000000000S000000001
100000000000000000000001
100000000000000000000001
100000000000000000000001
100000000000000000000001
111111111000000000000001
110100001000000000000001
110000101000000000000001
110100001000000000000001
110111111000000000000001
110000000000000000000111
111111111000000000000001
11111 111111111111111111