R  600 400

NO    textures/brick1.xpm

SO   textures/brick10.xpm
WE  textures/brick3.xpm  
EA textures/brick4.xpm

C    0,200,255 

F 254,128,128

111111111111111111111111
100000000000000000000001
100000000000000000000001
100000000000000000000001
100000000000000000000001
100000000000000000000001
100000000000000000000001
100000000000000000000001
100000000000000000000001
100000000000000000000001
100000000000000000000001
100000000000000000000001
100000000000000000000001
100000000000000000000001
100000000000000000000001
100000000000000000000001
100000000000000000000001
100000000000000000000001
100000000000000000000001
100000000000000000000001
100000000000000000000001
1000000000000000000000W1
111111111111111111111111